-35
32
-37
21
01111111111111111111111111111111111111111111111111111111111111111000
01000000000000000000000000000000000000000000000000000000000000001000
01000000000000000000000000000000000000000000000000000000000000001000
01000000000000000000000000000000000000000000000000000000000000001000
01000000000000000000000000000000000000000000000000000000000000001000
01000000000000000000000000000000000000000000000000000000000000001000
01000000000000000000000000000000000000000000000000000000000000001000
01000000000000000000000000000000000000000000000000000000000000001000
01000000000000000000000000000000000000000000000000000000000000001000
01000000000000000000000000000000000000000000000000000000000000001000
01000000000000000000000000000000000000000000000000000000000000001000
01000000000000000000000000000000000000000000000000000000000000001000
01000000000000000000000000000000000000000000000000000000000000001000
01000000000000000000000000000000000000000000000000000000000000001000
01000000000000000000000000000000000000000000000000000000000000001000
01000000000000000000000000000000000000000000000000000000000000001000
01000000000000000000000000000000000000000000000000000000000000001000
01000000000000000000000000000000000000000000011000000000000000001000
01000000000000000000000000000000000000111111100000000000000000001000
01000000000000000000000010000000000000111111100000000000000000001000
01000000000000000000000000000000000000111111100000000000000000001000
01000000000000000000000000100000000000111111100000000000000000001000
01000000000000000000000000000000000000111111100000000000000000001000
01000000000000000000000000000000000000111011100000000000000000001000
01000000000000000000000000000000000000111011100000000000000000001000
01000000000000000000000000000000000010001010001000000000000000001000
01000000000000000000000000000000000011111011111000000000000000001000
01000000000000000000000000000000000000000000000000000000000000001000
01000000000000000000000000000000000000000000000000000000000000001000
01000000000000000000000000000000000000000000000000000000000000001000
01000000000000000000000000000000000000000000000000000000000000001000
01000000000000000000000000000000000000000000000000000000000000001000
01000000000000000000000000000000000000000000000000000000000000001000
01000000000000000000000000000000000000000000000000000000000000001000
01000000000000000000000000000000000000000000000000000000000000001000
01000000000000000000000000000000000000000000000000000000000000001000
01000000000000000000000000000000000000000000000000000000000000001000
01000000000000000000000000000000000000000000000000000000000000001000
01000000000000000000000000000000000000000000000000000000000000001000
01000000000000000000000000000000000000000000000000000000000000001000
01000000000000000000000000000000000000000000000000000000000000001000
01000000000000000000000000000000000000000000000000000000000000001000
01000000000000000000000000000000000000000000000000000000000000001000
01000000000000000000000000000000000000000000000000000000000000001000
01000000000000000000000000000000000000000000000000000000000000001000
01000000000000000000000000000000000000000000000000000000000000001000
01000000000000000000000000000000000000000000000000000000000000001000
01000000000000000000000000000000000000000000000000000000000000001000
01000000000000000000000000000000000000000000000000000000000000001000
01000000000000000000000000000000000000000000000000000000000000001000
01000000000000000000000000000000000000000000000000000000000000001000
01000000000000000000000000000000000000000000000000000000000000001000
01000000000000000000000000000000000000000000000000000000000000001000
01000000000000000000000000000000000000000000000000000000000000001000
01000000000000000000000000000000000000000000000000000000000000001000
01000000000000000000000000000000000000000000000000000000000000001000
01000000000000000000000000000000000000000000000000000000000000001000
01000000000000000000000000000000000000000000000000000000000000001000
01000000000000000000000000000000000000000000000000000000000000001000
