-33
29
-37
21
111111111111111111111111111111111111111111111111111111111111111
000000000000000000000000000000000000000000000000000000000000001
000000000000000000000000000000000000000000000000000000000000001
000000000000000000000000000000000000000000000000000000000000001
000000000000000000000000000000000000000000000000000000000000001
000000000000000000000000000000000000000000000000000000000000001
000000000000000000000000000000000000000000000000000000000000001
000000000000000000000000000000000000000000000000000000000000001
000000000000000000000000000000000000000000000000000000000000001
000000000000000000000000000000000000000000000000000000000000001
000000000000000000000000000000000000000000000000000000000000001
000000000000000000000000000000000000000000000000000000000000001
000000000000000000000000000000000000000000000000000000000000001
000000000000000000000000000000000000000000000000000000000000001
000000000000000000000000000000000000000000000000000000000000001
000000000000000000000000000000000000000000000000000000000000001
000000000000000000000000000000000000000000000000000000000000001
000000000000000000000000000000000000000000011000000000000000001
000000000000000000000000000000000000111111100000000000000000001
000000000000000000000010000000000000111111100000000000000000001
000000000000000000000000000000000000111111100000000000000000001
000000000000000000000000100000000000111111100000000000000000001
000000000000000000000000000000000000111111100000000000000000001
000000000000000000000000000000000000111011100000000000000000001
000000000000000000000000000000000000111011100000000000000000001
000000000000000000000000000000000010001010001000000000000000001
000000000000000000000000000000000011111011111000000000000000001
111111111111000000001000110000000000000000000000011111111111111
111111111111000000000000001110000000000000001111111100011111111
111111111111000000000000000000000000000000000000000000001111111
000000000000000000000000000000000000000000000000000000000000001
000000000000000000000000000000000000000000000000000000000000001
000000000000000000000000000000000000000000000000000000000000001
000000000000000000000000000000000000000000000000000000000000001
000000000000000000000000000000000000000000000000000000000000001
000000000000000000000000000000000000000000000000000000000000001
000000000000000000000000000000000000000000000000000000000000001
000000000000000000000000000000000000000000000000000000000000001
000000000000000000000000000000000000000000000000000000000000001
000000000000000000000000000000000000000000000000000000000000001
000000000000000000000000000000000000000000000000000000000000001
000000000000000000000000000000000000000000000000000000000000001
000000000000000000000000000000000000000000000000000000000000001
000000000000000000000000000000000000000000000000000000000000001
000000000000000000000000000000000000000000000000000000000000001
000000000000000000000000000000000000000000000000000000000000001
000000000000000000000000000000000000000000000000000000000000001
000000000000000000000000000000000000000000000000000000000000001
000000000000000000000000000000000000000000000000000000000000001
000000000000000000000000000000000000000000000000000000000000001
000000000000000000000000000000000000000000000000000000000000001
000000000000000000000000000000000000000000000000000000000000001
000000000000000000000000000000000000000000000000000000000000001
000000000000000000000000000000000000000000000000000000000000001
000000000000000000000000000000000000000000000000000000000000001
000000000000000000000000000000000000000000000000000000000000001
000000000000000000000000000000000000000000000000000000000000001
000000000000000000000000000000000000000000000000000000000000001
000000000000000000000000000000000000000000000000000000000000001
