-23
23
-10
14
00000000000000000000000000000000000000000000000
00000000000000000000000000000000000000000000000
01111111111111111111111111111111111111111111110
01000000000000000000000000000000000000000000010
01000000000000000000000000000000000000000000010
01000000000000000000000000000000000000000000010
01000000000000000000000000000000000000000000010
01000000000000000000000000000000000000000000010
01000000000000000000000000000000000000000000010
01000000000000000000000000000000000000000000010
01000000000000000000000000000000011000000000010
01000000000000000000000000111111100000000000010
01000000000010000000000000111111100000000000010
01000000000000000000000000111111100000000000010
01000000000000100000000000111111100000000000010
01000000000000000000000000111111100000000000010
01000000000000000000000000111011100000000000010
01000000000000000000000000111011100000000000010
01000000000000000000000010001010001000000000010
01000000000000000000000011111011111000000000010
01000000000000000000000000000000000000000000010
01000000000000000000000000000000000000000000010
01000000000000000000000000000000000000000000010
01000000000000000000000000000000000000000000010
01111111111111111111111111111111111111111111110
