-23
23
-10
14
00000000000000000000000000000000000000000000000
00000000000000000000000000000000000000000000000
00000000000000000000000000000000000000000000000
00000000000000000000000000000000000000000000000
00000000000000000000000000000000000000000000000
00000000000000000000000000000000000000000000000
00000000000000000000000000000000000000000000000
00000000000000000000000000000000000000000000000
00000000000000000000000000000000000000000000000
00000000000000000000000000000000000000000000000
00000000000000001111111111111111111111000000000
00000000000000001000000000000000000001000000000
00000000000000001000000000000000000001000000000
00000000000000001000000000000000000001000000000
00000000000000001000000000000000000001000000000
00000000000000001000000000000000000001000000000
00000000000000001000000000000000000001000000000
00000000000000001000000000000000000001000000000
00000000000000001000000000000000000001000000000
00000000000000001000000000000000000001000000000
00000000000000001000000000000000000001000000000
00000000000000001000000000000000000001000000000
00000000000000001000000000000000000001000000000
00000000000000001000000000000000000001000000000
00000000000000001111111110001111111111000000000
